000000000000000000000000000
077777777777707777777777770
070000700000707000007000070
020000700000707000007000020
070000700000707000007000070
077777777777777777777777770
070000707000000000707000070
077777707777707777707777770
000000700000707000007000000
000000707777777777707000000
000000707000090000707000000
777777777095394690777777777
000000707000000000707000000
000000707777777777707000000
000000707000000000707000000
077777777777707777777777770
070000700000707000007000070
027770777777787777777077720
000070707000000000707070000
077777707777707777707777770
070000000000707000000000070
077777777777777777777777770
000000000000000000000000000